111111111111111111111111111
111111111111111000110000C11
10000000C00N0110011110N0011
101001010010011111100000111
1010010010101000N0001000011
1N0000000C00C01000000010C11
111111E11110111101100N00011
110P000000C00CNC01111100001
111111111111111111111111111