1111111111
1P0001C001
11110101C1
11110E0111
1111111111