1111111111111111111111111111111111
1E1000000000001C10000C000000000001
1000010100100001001001000000010101
1010010010101000001001000000010101
1P0000000C00C00000000N0000000000C1
1111111111111111111111111111111111